

R 501  500

S textures/sprite.xpm


WE textures/WE.xpm


SO textures/SO.xpm
NO textures/NO.xpm
EA textures/EA.xpm
C 185,209,206

F 91, 100, 99

 1111111
1000112111111111111111
1100000000000000000001111
102000000N0000000000011111111
1000001000000000000111111
111000100000000111111111111111
  111111020000000000000000000011
     110000020000000000000000111
     11000000002000000000000111
     11110000000000011111111111111
      1111010101010101
      11111111111111111
